+++++++++++++++++++++++
+                     +
+                     +
+                     +
+          ++         +
+         +0      A  a+
+          ++    ++  ++
+                     +  
+                     +
+                     +
+                     +
+                     +
+                     +
+                     +
+                     +
+                     +
+                     +
+++++++++++++++++++++++
